Applications 3 App Tech
Fall 1 Jim Horror
Temper 5 Sam Med
Adventures of Tom Sawyer: Mark Twain	Alice in Wonderland: Lewis Carrol
Agni Veena: Kazi Nasrul Islam	Ancient Mariner: Coleridge
Animal Farm: George Orwell	Arms and the Man: G.B.Shaw
Ben Hur: Lewis Wallace	Around the World in eighty days: Jules Verne
Baburnama: Babur	Anna Karenina: Leo Tolstoy
Arthashastra: Kautilya	Pride and Prejudice: Jane Austen
Anand Math: Bankimchandra Chattopadhyay	Le Contract Social: Jean Jacques Rousseau
Mein Kampf: Adolf Hitler	Gulliver’s Travels: Jonathan Swift
The Vicar of Wakefield: Oliver Goldsmith	A Dangerous place: D.P. Moynihan
The Decline and Fall of the Roman Empire: Edward Gibbon	Ain-i-Akbari: Abul Fazal
Akbar-Nama: Abul Fazal

Time Machine: H.G. Wells	The Lady of the Last Minstrel: Sir Walter Scott
A passage to India: E.M.Forster	Adventures of Sherlock Holmes: Arthur Conan Doyle
The Moon and Sixpence: Somerset Maughan	Raghuvamsa: Kalidas
Avigyan Sakuntalam: Kalidas

Shakuntala: Kalidas

Far from the Madding Crowd: Thomas Hardy	Discovery of India: Pandit Jawaharlal Nehru
Pilgrim’s Progress: From This World to That Which Is to Come: John Bunyan 	My Experiments with Truth: Mahatma M.K.Gandhi
The Merchant of Venice: Shakespeare
Antony and Cleopatra: Shakespeare

A Tale of Two Cities – Charles Dickens
David Copperfield – Charles Dickens

Geetanjali: Rabindra Nath Tagore	One Day in the Life of Ivan Denisovich: Alexander Solzhenitsyn
Utopia: Sir Thomas Moor	Origin of Species: Charles Darwin
Crime and Punishment: Dostoevsky	Das Kapital : Karl Marx
Chitra: R.N.Tagore	Count of Monte Cristo: Alexander Dumas
Bisarjan: R.N.Tagore	Canterbury Tales: Chaucer
Divine Comedy: Dante	The Wild Iris: Louis Gluck